11111111111111111
1000T00P0000T0001
1C000000T000000E1
10P0T00T0000P0001
11111111111111111