1111111111
1P000E1011
111T0P0C01
1C00011111
1111111111