111111111111111
1E00000000C0001
1111P000T0000C1
100000T11111111
11000000000C111
111111111111111