11111111111111
1E00C0C000P001
11111111111111